10000000000000000000-
10000000000000000000-
10000000000000000000-
11111000000000000000-
00001000000000000000-
00001111100000000000-
00000000100000000000-
00000000100000000000-
00000000100000000000-
00000000100000000000-
00000000111111111111




